20 20
********************
*_+________________*
*_+++++++_++++++++_*
*_+_____+_+______+_*
*_+_____+_+______+_*
*_+_____+_++++++++_*
*_+_____+_++___SS+_*
*S+_____+_++_+++++_*
*S+_____+_++_______*
*S+_____+_++++++++_*
*S+_____+_+______+_*
*S+_____+_+______+_*
*_+++++++_++++++++_*
*_SSS__b_________+F*
*++++++++++++++++++*
*__________________*
*__________________*
*__________________*
*__________________*
********************