20 20
********************
*_+________________*
*_+_______+________*
*_+_______+________*
*_+_______+________*
*_+________________*
*_+________________*
*S+________________*
*S+________________*
*S+________________*
*S+________________*
*S+_____b__________*
*_+++++++__+++++++_*
*_SSSS_bbSbb______F*
*+++++++++++++++++_*
*__________________*
*__________________*
*__________________*
*__________________*
********************